111111111111111111111111
10C0C0C0C0C0000000000001
100E00000000000000000001
10111110111110000C0C0001
100C0C000001111101111101
1000000P0000000000000001
111111111111111111111111
