1111111111111111111111111111
1000000000000000000000000001
1001111100000001111100000E01
100C0C0C0111110C0C0C00000001
100111110C0C0C01111100000001
100C0C0C0111110C0C0C00000001
100111110C0C0C01111100000001
100C0C0C0111110C0C0C00000001
100111110C0C0C01111100000001
1000000000000000000000000P01
1111111111111111111111111111
