111111111111111111111111
100000000000000000000001
100E0000000P000000000001
10000000011110000CCC0001
100CCC000001111000000001
1000000P0000000000000001
111111111111111111111111
