111111111111111111111111
100000000000000000000001
100E00000000000000000001
100000000111100000000001
100000000001111000000001
1000000P00000000001
111111111111111111111111
